XXXXXXXXXXXXXXXX XXXXXXXX
XoXX XX   XXX         XXX
X       X     XXXXXXX XXX
XX XX XXXXXXXX XX XXX XXX
XX                XXX XXX
XXXXX XXXXXXXX XXXXXX XXX
XXXXX0      XXXXXX    XXX
XXXXXXXXXXX X   XX XXXXXX
XXXXX       X X XX XXXXXX
XXXXX XXXXXXX X XX XXXXXX
XXXXX         X XX    XXX
XXXXXXXXXXXXXXX    XXXXXX
XXXXXXXXXXXXXXXXXXXXXXXXX