XXXXXXXXXXXXXXXXXXXXXXXXXXXXXXXXXXXXXXXXXXXXXXXXXXXXXXXXXXXXXXXXXXXXXXXXXXXXXXXXXXX
XXXXXXXXXXXXXXXXXXXXXXXXXXXXXXXXXXXXXXXXXXXXXXXXX       XXXXXXXXXX XXXXXXXXXXXXXXXX
XXXXXXXXXXXXXXXXXXXXXXXXXXXX             XXXXXXXX XXXXX XXXXXXXXXX XXXXXXXXXXXXXXXX
XoXX XX   XXX             XX XXXXXXXXXXX XXXXXXXX XXXXX            XXXXXXXXXXXXXXXX
X       X     XXXXXXX XXX XX XXXXXXXXXXX          XXXXXXXXXXXXXXXX XXXXXXXXXXXXXXXX
XX XX XXXXXXXX XX XXX XXX XX XXXXXXXXXXX XXXXXXXX XXXXXXXXXXXXXXXX                 .
XX                XXX XXX    XXXXXXXXXXX XXXXXXXX XXXXXXXXXXXXXXXX XXXXXXXXXXXXXXXX
XXXXX XXXXXXXX XXXXXX XXXXXXXXXXXXXXXXXX XXXXXXXX XXXXXXXXXX                XXXXXXX
XXXXX0      XXXXXX    XXXXXXXXXXXXXXXXXX XXXXXXXX XXXXXXXXXX XXXXX XXXX XXX XXXXXXX
XXXXXXXXXXX X   XX XXXXXXXXXXXXXX        XXXXXXXX XXXXXXXXXX XXXXX XXXX XXX XXXXXXX
XXXXX       X X XX XXXXXXXXXXXXXX XXXXXX          XXXXXXXXXX XXXXX XXXX XXX XXXXXXX
XXXXX XXXXXXX X XX XXXXXXXXXXXXXX XXXXXX XXXXXXXXXXXXXXXXXXX XXXXX XXXX XXX XXXXXXX
XXXXX         X XX    XXXXXXXXXXX XXXXXX XXXXXXXXXXXXXXXXXXX XXXXX XXXX XXX XXXXXXX
XXXXXXXXXXXXXXX    XXXXXXXXXXXXXX XXXXXX XXXXXXXXXX     XXXX XXXXX XXXX XXX     XXX
XXXXXXXXXXXXXXXXXXXXXXXXXXXX             XXXXXXXXXX XXX XXXX XXXXXXXXXX XXXXXXX XXX
XXXXXXXXXXXXXXXXXXXXXXXXXXXXXXXXXXXXXXXX XXXXXXXXXX XXX XXXX XXXXXXXXXX XXXXXXX XXX
XXXXXXXXXXXXXXXXXXXXXXXXXXXXXXXXXXXXXXXX            XXX XXXX XXXXXXXXXX         XXX
XXXXXXXXXXXXXXXXXXXXXXXXXXXXXXXXXXXXXXXXXXXXXXXXXXXXXXX      XXXXXXXXXXXXXXXXXX XXX
XXXXXXXXXXXXXXXXXXXXXXXXXXXXXXXXXXXXXXXXXXXXXXXXXXXXXXXXXXXXXXXXXXXXXXXXXXXXXXX XXX
XXXXXXXXXXXXXXXXXXXXXXXXXXXXXXXXXXXXXXXXXXXXXXXXXXXXXXXXXXXXXXXXXXXXXXXXXXXXXXXXXXX